Bus Open Data Service Data Catalogue
 GOV.UK

________________________________________
Data Catalogue
The data catalogue zip contains a series of CSVs which would gives a machine-readable overview of all the data that resides in BODS currently.
Note that the data catalogue only covers the data from primary data sources on BODS which is timetables data in TransxChange format, bus location data in SIRI-VM format and fares data in NeTEx format. Other non-primary data on BODS (e.g disruptions data or GTFS converted forms) are not represented on the data catalogue.
The data catalogue zip contains 4 distinct CSVs:
-	Overall data catalogue: this contains a high-level overview of all the static data on BODS: timetables and fares data.
-	Timetables data catalogue: this contains a detailed granular view of the timetables data within BODS. It also contains a detailed mapping of the BODS timetables data with the data from the Office of the Traffic Commissioner (OTC).
-	Organizations data catalogue: this contains helpful counts of data at an organization level: which is at the level of the publishing operators (e.g overall service data)

Field definitions:
The data catalogue contains certain fields the definitions and explanations of which can be found below.

Overall data catalogue:

Field name	Definition
BODS_REF	Data collected from the BODS accounts management systems
Published_XML	Data pulled directly from the XML files submitted by the publishers
Compliance and Data Quality	Data related to the results of the compliance and data quality checks on BODS
Geo	Data related to the location parameters extracted from the timetables data on BODS
OTC	Latest data from the records available at the Office of the Traffic Commissioner (OTC)
operator	The name of the operator/publisher providing data on BODS
operatorID	The internal BODS generated ID of the operator/publisher providing data on BODS
dataType	The type of data being published
status	The publication status of the data set/feed
lastUpdated	The date that the data set/feed was last updated on BODS
file name	The exact name of the file provided to BODS. This is usually generated by the publisher or their supplier
data set name	The internal BODS generated data set name given for a particular data set.
dataID	The internal BODS generated ID of the data set / feed provided to BODS
mode	The mode of transport as extracted from the TransXchange file they provided
NationalOperatorCode	The National Operator Codes for the particular publisher as extracted from the TransXchange file they provided
serviceCode	The ServiceCode for the particular publisher as extracted from the TransXchange file they provided
lineName	The linename for the particular publisher as extracted from the TransXchange file they provided


Timetables data catalogue:
Field name	Definition
Service_Status	The publication status of the publisher’s data set on BODS. ‘Registered/Unregistered’ refers to their status of registration with the OTC. ‘Published/Unpublished’ refers to if they have been published on BODS.
BODS_Organisation_Name	The name of the operator/publisher providing data on BODS
BODS_Timetable_datasetID	The internal BODS generated ID of the operator/publisher providing data on BODS
BODS_Dataset_DQ_Score	The DQ score assigned to the publisher’s data set as a result of the additional data quality checks done on timetables data on BODS
BODS_Dataset_Validation	The validation status and format of timetables data
BODS_Updated_Date	The date that the data set/feed was last updated on BODS
Published_Timetable_XMLFileName	The exact name of the file provided to BODS. This is usually generated by the publisher or their supplier
Published_Timetable_License_Number	The License number(s) as extracted from the files provided by the operator/publisher to BODS.
Published_Timetable_service's_NOC	The National Operator Code(s) as extracted from the files provided by the operator/publisher to BODS.
Published_Timetables_ServiceCode	The ServiceCode(s) as extracted from the files provided by the operator/publisher to BODS.
Published_Timetable_Public_Use_Flag	The Public Use Fag element as extracted from the files provided by the operator/publisher to BODS.
Published_Timetable_Operating_Period_Start_Date	The operating period start date as extracted from the files provided by the operator/publisher to BODS.
Published_Timetable_Operating_Period_End_Date	The operating period end date as extracted from the files provided by the operator/publisher to BODS.
Published_Timetable_service_Revision Number	The service revision number date as extracted from the files provided by the operator/publisher to BODS.
Published_Timetable_Line_Name	The line name(s) as extracted from the files provided by the operator/publisher to BODS.
Origin	The origin element as extracted from the files provided by the operator/publisher to BODS.
Destination	The destination element as extracted from the files provided by the operator/publisher to BODS.
Op_ID	The operator ID element as extracted from the database of the Office of the Traffic Commissioner (OTC)
Op_Name	The operator name element as extracted from the database of the Office of the Traffic Commissioner (OTC)
Address	The address as extracted from the database of the Office of the Traffic Commissioner (OTC)
Lic_No	The licence number element as extracted from the database of the Office of the Traffic Commissioner (OTC)
Licence_Status	The licence status element as extracted from the database of the Office of the Traffic Commissioner (OTC)
Reg_No	The registration number element as extracted from the database of the Office of the Traffic Commissioner (OTC)
Service_Type_Description	The service type description element as extracted from the database of the Office of the Traffic Commissioner (OTC)
Variation_Number	The variation number element as extracted from the database of the Office of the Traffic Commissioner (OTC)
Service_Number	The service number element as extracted from the database of the Office of the Traffic Commissioner (OTC)
start_point	The start point element as extracted from the database of the Office of the Traffic Commissioner (OTC)
finish_point	The finish point element as extracted from the database of the Office of the Traffic Commissioner (OTC)
via	The via element as extracted from the database of the Office of the Traffic Commissioner (OTC)
Granted_Date	The granted date element as extracted from the database of the Office of the Traffic Commissioner (OTC)
Exp_Date	The expiry date element as extracted from the database of the Office of the Traffic Commissioner (OTC)
effective_date	The effective date element as extracted from the database of the Office of the Traffic Commissioner (OTC)
received_date	The received date element as extracted from the database of the Office of the Traffic Commissioner (OTC)
Service_Type_Other_Details	The service type other details element as extracted from the database of the Office of the Traffic Commissioner (OTC)

Organisations data catalogue:
Field Name	Definition
{{ name }}	The name of the operator/publisher providing data on BODS
{{ status }}	The registration status of the operator/publisher on BODS. ‘Active’ are signed up on BODS, ‘Inactive’ no longer have functioning accounts on BODS and ‘Pending Invite’ have still haven’t signed up.
{{ invite_accepted }}	The date at which the operator/publisher accepted their invite and signed up
{{ invite_sent }}	The date at which they were originally invited to sign up to BODS
{{ last_active }}	The last time there was activity for the operator/publisher on BODS.
{{ permit_holder }}	The permit status as declared by operator/publisher in the Organisation profile section on BODS (Permit holder is 'Yes' if the user clicks the tickbox of 'I don't have a PSV license number')
{{ nocs_string }}	The National Operator Codes of the operator/publisher as declared by them in the Organisation Profile section on BODS.
{{ licence_string }}	The License number(s) of the operator/publisher as declared by them in the Organisation Profile section on BODS.
{{ number_of_licences }}	The total count of services of the operator/publisher as declared by them in the Organisation Profile section on BODS. This informs us to understand the total number of licence numbers the organisation is representing.
{{ number_of_services_valid_operating_date }}	The total number of services published on BODS that have a valid operating period today
{{ published_services_with_future_start_date }}	The total number of additional published services that have future start dates on BODS. This informs us to understand the additional number of new services codes that will become valid in the future, which is just a difference to the total already provided, to give an indicator to services that are published but not valid now.
{{ unregistered_service_count }}	The total number of unregistered services (UZ declared in ServiceCode field) are published in total by the operator/publisher to BODS.
{{ total_fare_products }}	The total number of fares products found in the fares data provided by the operator/publisher to BODS.
{{ published_timetable_count }}	The total number of published timetables datasets provided by the operator/publisher to BODS.
{{ published_avl_count }}	The total number of published location data feeds provided by the operator/publisher to BODS.
{{ published_fares_count }}	The total number of published fares datasets provided by the operator/publisher to BODS.
